456,456,456,456,456,295,423,423,424,456,456,456,456,456,456,422,423,423,423,423,296,456,456,456,456,456,456,295,424,422,456,326,456,390,456,295,424,456,456,456,456,422,296,456,456,456,456,456,456,456,456,456,456,456
456,456,295,423,423,424,456,456,456,456,456,456,456,456,456,456,456,456,456,456,390,456,456,456,456,456,456,392,456,456,456,456,456,422,423,424,456,456,456,456,456,456,390,456,456,456,456,456,456,456,456,456,456,456
456,295,424,456,456,456,456,456,456,456,456,456,456,456,456,456,456,456,456,456,390,456,456,456,456,456,295,424,456,456,456,456,456,456,456,456,456,456,456,456,456,456,390,456,456,456,456,456,456,456,456,456,456,456
456,392,456,456,456,456,456,456,456,456,456,456,456,456,456,456,456,456,456,456,422,423,423,296,456,295,424,456,456,456,456,456,456,456,456,456,456,456,456,456,456,456,390,456,456,456,456,456,456,456,456,456,456,456
456,392,456,456,456,456,456,456,456,456,456,456,456,456,456,456,456,456,456,456,456,456,456,422,423,424,456,456,456,456,456,456,456,456,456,456,456,456,456,358,359,359,328,456,456,456,456,456,456,456,456,456,456,456
456,392,456,456,456,456,456,456,456,456,456,456,456,456,456,456,456,456,456,456,456,456,456,456,456,456,456,456,456,456,456,456,456,456,456,456,358,359,359,328,456,456,456,456,456,456,456,456,456,456,456,456,456,456
456,392,456,456,456,456,456,456,456,456,456,456,456,456,456,456,456,456,456,456,456,456,456,456,456,456,456,456,456,456,456,456,456,456,456,456,422,296,456,456,456,456,456,456,456,456,456,456,456,456,456,456,456,456
456,392,456,456,456,456,456,456,456,456,456,358,359,359,360,456,456,456,456,456,456,456,456,456,456,456,456,456,456,456,456,456,456,456,456,456,456,390,456,456,456,456,456,456,456,456,456,456,456,456,456,456,456,456
456,392,456,456,456,456,456,456,456,456,358,328,456,456,327,360,456,456,456,456,456,456,456,456,456,456,456,456,456,456,456,456,456,456,456,456,456,422,423,423,423,296,456,456,456,456,456,456,456,456,456,456,456,456
456,392,456,456,456,456,456,456,456,358,328,452,456,456,456,327,360,456,456,456,456,456,456,456,456,456,456,456,456,456,456,456,456,456,456,456,456,456,456,456,456,422,296,456,456,456,456,456,456,456,456,456,456,456
456,392,456,456,456,456,456,456,358,328,456,456,453,456,456,456,392,456,456,456,456,456,456,456,456,456,456,456,456,456,456,456,456,456,456,456,456,456,456,456,456,456,390,456,456,456,456,456,456,456,456,456,456,456
456,392,456,456,456,456,456,456,390,456,456,455,456,456,453,456,392,456,456,456,456,456,456,456,456,456,456,456,456,456,456,456,456,456,456,456,456,456,456,456,456,456,390,456,456,456,456,456,456,456,456,456,456,456
456,392,456,456,456,456,456,358,328,453,456,456,456,456,456,452,392,456,456,456,456,456,456,456,456,456,456,456,456,456,456,456,456,456,456,456,456,456,456,456,456,456,390,456,456,456,456,456,456,456,456,456,456,456
456,327,360,456,456,456,358,328,456,456,456,456,456,455,456,295,424,456,456,456,456,456,456,456,456,456,456,456,456,456,456,456,456,456,456,456,456,456,456,456,456,456,390,456,456,456,456,456,456,456,456,456,456,456
456,456,327,359,359,359,328,452,456,456,456,454,456,456,456,392,456,456,456,456,456,456,456,456,456,456,456,456,456,456,456,456,456,456,456,456,456,456,456,456,456,358,328,456,456,456,456,456,456,456,456,456,456,456
456,456,456,456,456,456,456,456,456,456,453,456,456,456,295,424,456,456,456,456,456,456,456,456,456,456,456,456,456,456,456,456,456,456,456,456,456,456,456,456,456,390,456,456,456,456,456,456,456,456,456,456,456,456
456,456,456,456,295,423,296,456,456,456,456,456,452,295,424,456,456,456,456,456,456,456,456,456,456,456,456,456,456,456,456,456,456,456,456,456,456,456,456,456,358,328,456,456,456,456,456,456,456,456,456,456,456,456
456,456,456,456,392,456,422,423,296,456,456,456,295,424,456,456,456,456,456,456,456,456,456,456,456,456,456,456,456,456,456,456,456,456,456,456,456,456,456,456,390,456,456,456,456,456,456,456,456,456,456,456,456,456
456,456,456,456,392,456,456,456,422,423,296,295,424,456,456,456,456,456,456,456,456,456,456,456,456,456,456,456,456,456,456,456,456,456,456,456,456,456,456,358,328,456,456,456,456,456,456,456,456,456,456,456,456,456
456,456,456,456,327,360,456,456,456,456,422,424,456,456,456,456,456,456,456,456,456,456,456,456,456,456,456,456,456,456,456,456,456,456,456,456,456,456,358,328,456,456,456,456,456,456,456,456,456,456,456,456,456,456
456,456,452,456,456,392,456,456,456,456,456,456,456,456,456,456,456,456,456,456,456,456,456,456,456,456,456,456,456,456,456,456,456,456,456,456,456,358,328,456,456,456,456,456,456,456,456,456,456,456,456,456,456,456
456,456,456,456,456,392,456,456,456,456,456,456,456,456,456,456,456,456,456,456,456,456,456,456,456,456,456,456,456,456,456,456,456,456,456,456,358,328,456,456,456,456,456,456,456,456,456,456,456,456,456,456,456,456
456,456,456,456,456,392,456,456,456,456,456,456,456,456,456,456,456,456,456,456,456,456,456,456,456,456,456,456,456,456,456,456,456,456,456,456,390,456,456,456,456,456,456,456,456,456,456,456,456,456,456,456,456,456
456,456,456,456,456,327,359,360,456,456,456,456,456,456,456,456,456,456,456,456,456,456,456,456,456,456,456,456,456,456,456,456,456,456,456,456,390,456,456,456,456,456,456,456,456,456,456,456,456,456,456,456,456,456
456,456,456,456,456,452,456,392,456,456,456,456,456,456,456,456,456,456,456,456,456,456,456,456,456,456,456,456,456,456,456,456,456,358,359,359,328,456,456,456,456,456,456,456,456,456,456,456,456,456,456,456,456,456
456,456,456,456,456,456,456,327,360,456,456,456,456,456,456,456,456,456,456,456,456,456,456,456,456,456,456,456,456,456,456,456,358,328,456,456,456,456,456,456,456,456,456,456,456,456,456,456,456,456,456,456,456,456
456,456,456,456,456,456,456,456,327,360,456,456,456,456,456,456,456,456,456,456,456,456,456,456,456,456,456,456,456,456,456,358,328,456,456,456,456,456,456,456,456,456,456,456,456,456,456,456,456,456,456,456,456,456
456,456,456,456,456,456,456,456,456,327,360,456,456,456,456,456,456,456,456,456,456,456,456,456,456,358,359,359,359,359,359,328,456,456,456,456,456,456,456,456,456,456,456,456,456,456,456,456,456,456,456,456,456,456
456,456,456,456,456,456,456,456,456,456,327,359,359,360,456,456,456,456,456,456,456,456,358,359,359,328,456,456,456,456,456,456,456,456,456,456,456,456,456,456,456,456,456,456,456,456,456,456,456,456,456,456,456,456
456,456,456,456,456,452,456,456,456,456,456,456,456,327,359,359,359,359,359,359,359,359,328,456,456,456,456,456,456,456,456,456,456,456,456,456,456,456,456,456,456,456,456,456,456,456,456,456,456,456,456,456,456,456
456,456,456,456,456,456,456,456,456,456,456,456,456,456,456,456,456,456,456,456,456,456,456,456,456,456,456,456,456,456,456,456,456,456,456,456,456,456,456,456,456,456,456,456,456,456,456,456,456,456,456,456,456,456
456,456,456,456,456,456,456,456,456,456,456,456,456,456,456,456,456,456,456,456,456,456,456,456,456,456,456,456,456,456,456,456,456,456,456,456,456,456,456,456,456,456,456,456,456,456,456,456,456,456,456,456,456,456
456,456,456,456,456,456,456,456,456,456,456,456,456,456,456,456,456,456,456,456,456,456,456,456,456,456,456,456,456,456,456,456,456,456,456,456,456,456,456,456,456,456,456,456,456,456,456,456,456,456,456,456,456,456
456,456,456,456,456,456,456,456,456,456,456,456,456,456,456,456,456,456,456,456,456,456,456,456,456,456,456,456,456,456,456,456,456,456,456,456,456,456,456,456,456,456,456,456,456,456,456,456,456,456,456,456,456,456
456,456,456,456,456,456,456,456,456,456,456,456,456,456,456,456,456,456,456,456,456,456,456,456,456,456,456,456,456,456,456,456,456,456,456,456,456,456,456,456,456,456,456,456,456,456,456,456,456,456,456,456,456,456
